6 2 2 4 0 0
2 2 2 4,3,5 2 2
2 0 0 0 0 2
2 0 0 0 0 2
2 0 1 0 0 2
2 1 0 0 0 2
2 2 2 2 2 2