2 13 10 9 5 0 
2 2 2 2 2 4,3,5,0 2 2
2 0 0 3,3,1,0 0 0 5 2
2 0 0 0 3,1,1,0 0 0 2
2 0 1 3,3,1,0 0 0 0 2
2 0 0 0 3,1,1,0 0 0 2
2 0 0 3,3,1,0 0 0 0 2
2 1 0 0 3,1,1,0 0 0 2
2 2 2 2 2 2 2 2