2 10 5 10 5 0 
2 2 2 2 2 4,3,6,2,1 2 2
2 0 3,2,2,0 0 0 0 0 2
2 0 2 0 2 0 0 2
2 0 0 0 0 0 5 2
2 1 2 3,1,3,1 2 0 0 2
2 1 0 3,2,2,1 0 0 0 2
2 0 2 0 2 0 0 2
2 2 2 2 2 2 2 2