3 14 10 15 10 5
2 2 2 2 2 2 2 2 2 2
2 0 0 0 0 0 0 0 1 2
2 0 0 0 4,3,3,0 0 3,2,3,1 0 0 2
2 0 0 3,3,2,0 0 4,2,1,4,1 0 4,3,1,4,0 0 2
2 3,2,2,0 0 0 0 0 5 0 0 2
2 0 1 0 0 4,1,1,4,2 0 4,4,1,4,3 0 2
2 0 0 0 4,2,3,0 0 0 0 0 2
2 4,2,3,2,0 0 0 0 0 0 0 4,4,3,2,1 2
2 0 1 0 0 0 0 3,4,4,0 0 2
2 2 2 2 2 2 2 2 2 2